15.ox
........o..o
..oo........o..
..........o....
...............
.....o.......o.
....o..o.......
......o.o......
.......o......o
......o........
..........o..oo
........o......
.o.o.....o...o.
......oo..o.o..
o.........o.o.o
..o.o.....o..o.